GalbraithHall - Revelle
GalbraithHall - YorkHall
OslerParking - BioMedLib
Revelle - MainGym
YorkHall - BioMedLib
MainGym - Mandeville
Muir - APM
Mandeville - APM
CenterHall - PriceCenter
CenterHall - UniversityCenter
GilmanParking - PepperCanyonHall
PepperCanyonHall - MAE
UniversityCenter - GilmanParking
Sixth - MAE
MAE - WarrenLectureHall
APM - PetersonHall
PetersonHall - SolisHall
PriceCenter - Geisel
SolisHall - Marshall
SolisHall - Geisel
WarrenLectureHall - CSE
Jacobs - WarrenLectureHall
Marshall - OceanView
CSE - Warren
OceanView - PangeaParking
PangeaParking - ERC
HopkinsParking - SupercomputerCenter
SupercomputerCenter - RIMAC
ERC - Rady
RIMAC - Rady
